new york liberty of movement|new york-based free china movement|n.y.-based free sino movement
Afghanistan|Afghan
Albania|Albanian
Algeria|Algerian
American Samoa|American Samoan
Andorra|Andorran
Angola|Angolan
Anguilla|Anguillan
Argentina|Argentine|Argentinian
Republic of Armenia|Armenia|Armenian
Aruba|Aruban
Australia|Australian
Austria|Austrian
Republic of Azerbaijan|Azerbaijan|Azerbaijani
The Bahamas|Bahamas|Bahamian
Bahrain|Bahraini
Bangladesh|Bangladeshi
Barbados|Barbadian
Republic of Belarus|Belarus
Belgium|Belgian
Belize|Belizean
Benin|Beninese
Bermuda|Bermudian
Bhutan|Bhutanese
Bolivia|Bolivian
Bosnia|Bosnian
Brazil|Brazilian
Brunei|Bruneian
Bulgaria|Bulgarian
Burkina|Burkinabe
Burma|Burmese
Burundi|Burundian
Cambodia|Kampuchea|Cambodian
Cameroon|Cameroonian
Canada|Canadian
Cape Verde|Cape Verdean
Cayman Islands|Caymanian
Central African Republic|Central African
Chad|Chadian
Chile|Chilean
China|PRC|P.R.C.|People's Republic of China|Chinese|Sino
Colombia|Colombian
Comoros|Comoran
Congo|Congolese
Costa Rica|Costa Rican
Crimea|Crimean
Croatia|Croatian|Croat
Cuba|Cuban
Cyprus|Cypriot
Czechoslovakia|Czech Republic|Czech|
Denmark|Danish|Dane
Dominican Republic|Dominican
Ecuador|Ecuadoran|Ecuadorian
Egypt|Egyptian
El Salvador|Salvadoran
Republic of Estonia|Estonia|Estonian
Ethiopia|Ethiopian
Faroe Islands|Faroese
Fiji|Fijian
Finland|Finnish|Finn
France|French
French Guiana|French Guyana
The Gambia|Gambia|Gambian
Republic of Georgia|Georgian
German Democratic Republic|East Germany
Germany|West Germany|Federal Republic of Germany|German
Ghana|Ghanaian
Greece|Greek
Greenland|Greenlandic|Greenlander
Grenada|Grenadian
Guam|Guamian
Guatemala|Guatemalan
Guinea|Guinean
Guyana|Guyanese
Haiti|Haitian
Honduras|Honduran
Hong Kong|Hongkong
Hungary|Hungarian
Iceland|Icelandic
India|Indian
Indonesia|Indonesian
Iran|Iranian
Iraq|Iraqi
Ireland|Republic of Ireland|Irish Republic|Irish|Irishman|Irishwoman|Irish
Israel|Israeli
Italy|Italian
Jamaica|Jamaican
Japan|Japanese
Jordan|Jordanian
Republic of Kazakhstan|Kazakhstan|Kazakstan|Khazakstan
Kenya|Kenyan
Republic of Korea|Korea|South Korea|Korean|rok|South Korean
Kosovo|Kosovar
Democratic People's Rep. Korea|Democratic Peoples Republic of Korea|North Korea
Kuwait|Kuwaiti
Republic of Kyrghyzstan|Kyrghyzstan
Laos|Laotian
Republic of Latvia|Latvia|Latvian
Lebanon|Lebanese|Lebanese
Liberia|Liberian
Libya|Libyan
Republic of Lithuania|Lithuania|Lithuanian
Madagascar|Malagasy
Malawi|Malawian
Malaysia|Malaysian
Maldives|Maldivian
New York City|New York
Malta|Maltese
Mauritania|Mauritanian
Mauritius|Mauritian
Mexico|Mexican
Republic of Moldova|Moldova
Mongolia|Mongolian
Morocco|Moroccan
Namibia|Namibian
Nepal|Nepalese|Nepalese
Netherlands|Dutch|Dutch
Netherlands Antilles|Antilles
Nicaragua|Nicaraguan
Nigeria|Nigerian
Norway|Norwegian
Pakistan|Pakistani
Palestine|Palestinian Authority|Palestinian
Panama|Panamanian
Paraguay|Paraguayan
Peru|Peruvian
Philippines|Philippine|Filipino
Poland|Polish|Pole
Portugal|Portuguese|Portuguese
Polynesia|Polynesian
Puerto Rico|Puerto Rican
Qatar|Qatari
Romania|Romanian
Russian Federation|Russia|Russian
Russia|Russian
Rwanda|Rwandan
France|French
Saudi Arabia|Saudi
Senegal|Senegalese|Senegalese
Serbia|Serbian|Serb
Slovenia|Slovenian|Slovene
Somalia|Somali
South Africa|Republic of South Africa|South African
Spain|Spanish|Spaniard
Sudan|Sudanese|Sudanese
Sweden|Swedish|Swede
Switzerland|Swiss|Swiss
Syria|Syrian
Tahiti|Tahitian
Taiwan|Republic of China|Taiwanese
Republic of Tajikistan|Tajikistan
United Republic of Tanzania|Tanzania|Tanzanian
Thailand|Thai|Thai
Tibet|Tibetan
Tunisia|Tunisian
Turkey|Turkish|Turk
Republic of Turkmenistan|Turkmenistan
Turks and Caicos Islands|Turks Islands|Caicos Islands
Tuvalu|Tuvaluan
Uganda|Ugandan
Republic of Ukraine|Ukraine|Ukrainian|Ukrainian
United Kingdom|UK|U.K.|Britain|British|Briton|Englishman|Englishwoman|British
England|English
United States|US|U.S.|USA|U.S.A.|United States of America|America|American|Americans
Uruguay|Uruguayan|Montevideo
USSR|U.S.S.R.|Soviet Union|Soviet
Republic of Uzbekistan|Uzbekistan|Uzbek
Venezuela|Venezualan
Vietnam|Vietnamese
South Yemen|Yemen|Yemeni
Yugoslavia|Yugoslav
Zaire|Zairian
Zambia|Zambian
Zimbabwe|Zimbabwean
Africa|African
Asia|Asian
Europe|European
North America"
South America|South American
Scandinavia|Scandinavian
Central America|Central American
Latin America|Latin American
Alabama|Ala.
Arizona|Ariz.
Arkansas|Ark.
California|Calif.
Colorado|Colo.
Connecticut|Conn.
Delaware|Del.
Florida|Fla.
Georgia|Ga.
Illinois|Ill.
Indiana|Ind.
Kansas|Kan.
Kentucky|Ky.
Louisiana|La.
Maryland|Md.
Massachusetts|Mass.
Michigan|Mich.
Minnesota|Minn.
Mississippi|Miss.
Missouri|Mo.
Montana|Mont.
Nebraska|Neb.
Nevada|Nev.
New Hampshire|N.H.
New Jersey|N.J.
New Mexico|N.M.
New York|N.Y.
North Carolina|N.C.
North Dakota|N.D.
Oklahoma|Okla.
Oregon|Ore.
Pennsylvania|Pa.
Rhode Island|R.I.
South Carolina|S.C.
South Dakota|S.D.
Tennessee|Tenn.
Vermont|Vt.
Virginia|Va.
Washington State|Wash.
West Virginia|W.Va.
Wisconsin|Wis.
Wyoming|Wyo.
Agence France-Presse|Agence France-Presse (AFP)|AFP
percent|%
United Nations|UN
The Associated Press|Associated Press|AP
teather|tirso
cable news network|cnn
timoshenko|tymoshenko
yanukovich|yanukovych
gryszlov|grizlov
united nations children ' s fund|un children ' s fund|unicef
tiananmen square|tiananmen
nais|ness|neiss
european union|eu
justice and truth alliance|justice and truth coalition
social democrat party|social democratic party
BNP Paribas|Paribas
ufj institute|ufj research institute
pan jiwen|ban ki-moon
north and south korea|north korea and south korea
abderraman|abdelrahman
gonzalez|gonzales
basque|pascual
cpc|central committee
new york liberty of movement|new york-based free china movement
united nations security council|un security council
chen chung|chen zhong
chen tangshan|mark chen
liu shanshan|jacqueline liu
ge tianhao|keegan
american institute in taiwan|united states in taiwan association|american institute in taiwanese|american institute in taiwan|united states in taiwanese association|american in taiwanese association|united states taiwan institute|american taiwan institute|american taiwanese institute|united states taiwan association|american taiwan association|american taiwanese association|ait
hsinyi road|hsin yi road
bethelhem|bethlehem
russia 's state oil company|russian state oil company
russia 's|russia's|russian
baikalfinansgroup|baikal financial group
russian state gas company|russia 's state gas company
khodokovsky|khodorkovsky
central commission|central committee
ministry of internal affairs and communications|general province|general provincial
heakes|hicks
stein|stern
coordination of humanitarian affairs office|office for the coordination of humanitarian affairs
Banda Aceh|jakarta|aceh
world health organization|who
health ministry|ministry of health
united nations children's fund|united nations children ' s fund
chrowder|crowder
lee jong-wook|li zhongyu
liberation tigers of tamil eelam|liberation tigers
chikov|zykov
altay republic|altai republic
business sector|commerce department
zeng qinghong|ceng qinghong
hong kong|hongkong
tian jiyun|jiyun tian
cpc central committee|central committee
information center for human rights and democracy|hina information center for human rights and democracy
jiji press|jiji
the new york liberty of movement|new york-based free china movement
xinhua news agency|xinhua
shaks|sachs
shanghai turbogenerator ltd|shanghai steam turbine generator co., ltd
united nations educational , scientific and cultural organization|un educational , scientific and cultural organization|unesco
city financial bureau|municipal finance bureau
shanghai turbine generator co,. ltd|shanghai turbogenerator co. ltd.
shanghai electric power generation group|hanghai power plant equipment manufacturing
shanghai electric power group|shanghai electric and power station group|shanghai electric power station group
shanghai turbine works companies|shanghai steam turbine company
bad weather information centre|bad weather information center|worst weather information centre|worst weather information center|severe weather information center|severe weather information centre
joint influenza research center|influenza research center
center for disease control and prevention|center of disease prevention and control
house of representatives international relations committee|ministry of foreign affairs commission|ministry of foreign affairs
us house committee on international relations|house international relations committee
national bureau of oceanography|state oceanic administration|state bureau of oceanic administration
the standing committee of the political bureau of the cpc central committee|cpc politburo standing committee
the standing committee of the political bureau|politburo standing committee
ceng peiyan|zeng peiyan
andean presidential council|andean community
andean community|sadc
venezuelan|venezuela
china three gorges project development corporation|china yangtze river three gorges project development corporation
shaanxi province|shanxi province|shaanxi|shanxi
taiwan province|taiwan
economic community of west african states|ecowas
unoci|united nations in the operation in resolving the crisis
xian|xi'an
james morris|james murray
shanxi environmental protection bureau|shaanxi environmental protection bureau
united self-defence forces|united self-defense forces
colombian united self-defence forces|auc
right jiang| youjiang
chinese workers and peasants red army|chinese workers and peasants seventh army
bai se|baise
yuedong guildhall|patriotic education bases
shanghai network development company ltd.|shanghai grand network development company limited|shanghai shanda networking (group) co., ltd.
asset management co. ltd|asset management ltd
united nations drug control and crime prevention|united nations office
united nations drug control and crime prevention of the office|un office of drug control and crime prevention
guant�namo|guantanamo
us defense department|us defense
gordon . england|gordon england
state council|state department
defence ministry|defense department
al-qa'idah|al-qaeda|al-qaeda
shanghai information industry ( group ) company limited|shanghai information industry (group) company limited
yang yuan-yuan|yang yuanyuan
japan international cooperation agency ( jica ) bank|japan bank for international cooperation
us trade development council|us trade and development agency
yehovah|jehovah
israeli museums|israel museum
avigdo|avigad
shenzhen city , the water supplies department|shenzhen water board
phuket|phuket island
pp. island|phi phi island
hangzhou , china travel service|hangzhou china travel service
cai wei wei|cai weiwei
oint engineering company|united engineering corporation
mulki|muasher
supreme electoral council|supreme election commission
commissioner of banking|china banking regulatory commission|cbrc
industrial and commercial bureau|administration of industry and commerce
shanghai business websites|shanghai municipal administration
eastern airlines|china eastern airline
germany symphony|deutsches symphonie
hainan|hainan province
fujian|fujian province
political bureau of the cpc central committee|politburo of the communist party of china
state physical cultural administration|state administration of physical culture and sports and coordination|state sports general bureau|state general administration of sports
carton|catton
beijing candy recreation space|beijing tango ktv disco bar
apec study centre|center for asia pacific economic cooperation
zhou yiqing|chow yei-ching
jierong zhou|zhou xierong
the central electoral commission|general election commission|ukrainian central election committee
yokohama zhongshan memorial hall|sun yat sen memorial hall
overseas chinese association|association of overseas chinese
louis castaneda|luis castaneda
national people's congress|npc
commonwealth of independent states|cis
collective security treaty organization|csto
commonwealth of independent states collective security treaty|cis collective security treaty organization council
zhang miao miao|zhang miaomiao
municipal gardens bureau|municipal bureau of parks
Greece|Greek